3333333333333333333333333
3000000000000000000000003
3111000000000000000000003
3000001100000000000110013
3000000000110001100000003
3000000000000000000001113
3000000000000000011000003
3000000001100110000000003
3110011000000000000000003
3001000000000000000000003
3000100000000000000000003
3000010000000000000000003
3000001100011100110110003
3000000000000000000000003
3000000000000000000001113
3000000110001100011000003
3001100000000000000000003
3000000000000000000000003
3111111100011000110011113
3333333333333333333333333