0000000000000000000000000
0111111111122222222111110
0222111111111111111111110
0111112211111111111221120
0111111111112211122111110
0112222222111111111112220
0111111111111111122211110
0111111112211221111111110
0221122222211111111111110
0112111111111111111111110
0111211111111111111111110
0111121111111111111111110
0111112211122211221221110
0222222211111111111111110
0111111111111111111112220
0111111221112211122111110
0111221111111111111111110
0211111111111111111111110
0222222211122111222222220
0000000000000000000000000