1111111111111111111111111
1222222222222222222222221
1111222222222222222222221
1222221122222222222112211
1000000000110001100000001
1000000000000000000001111
1000000000000000011000001
1000000001100110000000001
1110011000000000000000001
1001000000000000000000001
1000100000000000000000001
1000010000000000000000001
1000001100011100110110001
1000000000000000000000001
1000000000000000000001111
1000000110001100033222221
1001122222222222222222221
1222222222222222222222221
1333333322233222332233331
1111111111111111111111111